*************************************************** *************************************************
*             *     *         *   *               *   *       *           *   *   *       *       * *
* ******* * *** * * * *** *** * * * ***** ***** * *** *** *** ********* *** *** *** ***** * * ***** *
* *       *   * *     * * * *   * * *       * * *         *       *   *   * * *       *     *   *   *
* * ********* * ******* * * *** ******* *** * * * * * * *** ***** *** * *** * *** ***** ***** *** * *
* * *       *     * *   * *   *         *   *   * * * * * * * *         *   *     *     *   *     * *
* ***** ***** * * * * * *** ***** ********* *** *** * * * * * *** * * *** *** *** ***** * *** * * ***
* * * *     * * * * * *       *         *   *     * * *   * *     *   *       *   *   *   *   * *   *
* * * * *** * *** * *** ******* *** *** * *** * ********* ********* * *** *** * *** ***** * *** *****
* *   *   * * *         * *   * *   *   *   * *   * *         * *   *     *   * *     * * * * *     *
* *** *** * * * ******* * * ******* *** *** *** *** *** * * *** * * ***** *** *** * *** ***** ***** *
*         *   *   * *       *     * *   * * *     *     * *     * * *   *       * *   * *     *     *
* * ******* ***** * *** *** ***** * *** * * *** ********* *** *** *** * * *** *** * *** * * ******* *
* *     * * *     *   * *   * *     * * * * * *     *       *     *   *   *   * * *     * * *     * *
* * ***** * * * ***** * *** * ***** * *** * * * * *** ***** * *** *** ***** * * ***** * * *** *** * *
* *   *   * * *   *       * * *   *   *     *   * * * *     *   * * *   * * *   *     * * *       * *
* ***** * *** *** * ******* * * * ********* ***** * * * * *** ***** ***** *** * * * * *** * ***** ***
*       * *   * * *   *         *     *   * * *     * * * * *   *   *         *   * *       * *   * *
*** * * *** *** *** ******* * ********* ***** *** * * *** * * *** ******* ***** * *** * *** * *** * *
* * * * *   * *   *   * *   *       *             *     *   *       *   *   *   * *   * * * *   * * *
* * ***** * * * * * * * * * * * * * ***** ******* ***** *** ***** *** ***** ***** * *** * * * *** * *
*   * *   *     * * *   * * * * * *   * *     * *       * *     *     *     *     *   *   *   * *   *
* *** ******* * * * * *** ******* *** * ***** * * * *** * ***** ***** * *** ******* ********* * * * *
* *         * * * * * *   * *   * *   * *   *   * * * *     *   *   * *   * * *         *       * * *
* ******* ******* * * *** * *** * ***** *** * ******* ***** ***** * *** ***** * *** * ********* *** *
* *   * *     *   * * *     *     *     *     *   *       *   * * *         *   * * *   *     * *   *
* * *** *** *** ******* *** * *** *** *** *** *** ******* * *** * ***** *** ***** *** ******* * *** *
*     *           *   * *   * *     *     *   *   *     *   *     *   *   * *   *   * *         * * *
***** *** ***** * * *** * *** ********* *** *** ***** *** ******* *** *** *** *** * ******* *** * * *
*     *     * * *   * * * * *     *     *   *             *   * * *     *       * *     * * * * *   *
* *** * *** * * *** * * *** * *** ***** * ******* * *** * *** * * ***** *********** *** * * * * *** *
* *   * * * *   *   *   *     *     * * *   *     * * * * * *               *     * * *     * *   * *
* *** *** ********* *** ***** ******* * *** *** *** * * *** * *** ********* *** * * * * *** * * *** *
* * *       *   * *   *     *   *   *     *       *   * * * *   *   * * * * *   *   *   * * * * * * *
* * *** *** *** * *** *** * *** * * * * *********** * *** * ***** * * * * ***** *** *** * * * *** * *
*   *   * *       *     * * *   * *   *     *       * * *     *   * * *   *     * * *     * *     * *
* ******* ***** ********* * * ***** *** * ************* * *** * ***** *** * *** * * ***** * * * *** *
*         * *   *   *     *       * *   *           *     *     *           *   * * *   * * * *   * *
* *** *** * *** * *** *** *************** *** * ***** *** *** * * * *** ***** *** * *** * ******* * *
*   * * * * *       *   *   *     *     * *   *         * *   * * * *   * *       * *   * * *     * *
*** *** *** *********** * ***** * * *********** *** *** * ***** ******* * * *** * *** ***** *** *** *
*   * * *     *     *   * *     *   *   *         *   * * * * *     *   *     * *       *   * *     *
* * * * ***** * * * * * *********** * ********* ******* * * * ***** * *** ******* ********* * * * * *
* *         * * * * * * *       *   * *     *   * *   * *     *       *           *   * * * *   * * *
* *** ***** * * *** ******* * * *** * * *** * *** * ********* * *** *************** * * * * ******* *
* * * *   *       *   *   * * *           *   *           *   *   *         *     * *             * *
* * ***** ********* ***** *** ******* ********* ***** ***** ***** * * * * * * *** ************* * ***
* *           *   *             * * *       * * * * *     *   * * * * * * *     * *     *       *   *
* ***** *** *** * * * * ******* * * ***** * * *** * ***** *** * *** ******* ********* *** * *** * ***
* * * * * * *   * * * *   *   *   * *     * *               *   *         *       * * *   *   * * * *
* * * *** * * * ******* *** ***** * * * *** ********* * * *** *** ***** * * *** * * * * ******* *** *
* *         * * *         *     * *     *   *     *   * * *   * * * *   * *   * *         *     *   *
* * ***** * *** *** * ***** ************* *** *** *** * *** * * *** * *** ***** ********* * ******* *
*   *     * *       * *     *   *   *   *     *   *   * *   *       * * * *   * *       * *     *   *
* * *** * * * * * *** * * * * * *** *** *** * * *** * ******* ***** *** ***** *** ***** * ********* *
* * *   * *   * *   *   * * * *   *   *     *   *   *       *   *   *     * * *   * *     *   * * * *
* ************* * * ***** * * * ***** *********** * ***** ***** * ***** * * * * * * * * * *** * * * *
* *         *   * *   *   *   *     * *           *   *   *     * *   * * *     *   * * *   * *     *
***** * *** * *** ********* *** * *** *** *** * *** * ***** ******* ***** ***** *********** * * *** *
*     *   * *   *   * *   *   * *     *     * *   * *   *     *       * *     * *     * *   *   *   *
* ******* * ******* * * * * *** *** * ***** ***** * ***** * ******* *** *** *** *** * * * * *** *** *
* * *     *           * * *   * * * *         * * *     * *     *         *   * *   *   * *       * *
* * * ***** * *** ******* ***** * ***** * ***** * *** * *** * ***** ***** *** * *** * * ******* *** *
*   *     * *   *     *         *     * * * *   * * * *   * *     *   *         *   * *   * *   *   *
* *** *** * * * *** * ***** ***** *** * *** * *** * * * *** ***** * * * ***** *** * * ***** *** *** *
*   * * * * * * *   *   * *   * *   *     *         * *       * *   * * *     *   * * *       * *   *
*** *** ********* * ***** *** * *** * * ***** *** ***** ***** * ***** ********* ***** * * * ******* *
*       *     * * *     *         * * *     * * * *   *   *     *   * *       * *   * * * * *     * *
* ***** ***** * * * ***** * ******* * *** *** * ***** ********* *** * ***** * *** * * ***** * ***** *
* *   * * * *           * *   *     * *   *     *   *         *             *   * *       *         *
* * *** * * ************* ******* ***************** * ******* ********* *** *** *** *** ***** * *** *
* *   *         * *   *     *         * * *     *   * * * *           *   * *     * *         * *   *
* * ***** ***** * * * * * *** * ******* * * ******* *** * *** ***** *** ************* * * ***** *** *
*       * *     * * * * *     * *   * *   *             * *   * *                 *   * *     * * * *
* * ********* *** * * * ********* * * * ******* * ***** * *** * *** ***** *** ******* *** * *** * * *
* *   *     *       * * *   * *   *             * *   * *     *     *     * * * * *     * *   * *   *
* * ******* * * ***** * *** * *** *** *** ******* * * *** * *** * *** *** * *** * ******* ***** *** *
* *   * *   * *   *         *   * *     * * * *     *   * *   * * *   *     *     *         *   * * *
* ***** * * *** ******* *** *** * *** ***** * * *** ************* * *** *** *** * * *** ***** *** * *
*   *     * *   *   *     * *   * * * *       * *         *     * *   *   *     *   * *   *   *   * *
* * *** ***** ***** * ***** * * * * *** ***** * *** ******* ***** ***** ********* * * ***** *** *** *
* *       *   *     * *   *   * * *         * * *   *         * * *       * *   * * *               *
* ******* * * ***** ***** *** ******* ***** *** * ***** * * * * * * ******* *** ******* ***** * *****
* *     *   * *       * * * * *   * *   *     * *   * * * * *   * *   *   *   *   * * * * *   * * * *
*** * *** *** *** * *** * * * * * * *** ***** * ***** *** ***** * * * *** * * *** * * *** * ***** * *
*   *     *       * *   *     * *   *         * * *       * * * * * *     * *     *       *       * *
* *********** * * * *** ********* * * ********* * * ***** * * * * * * *** * ***** * ******* ******* *
*           * * * * *     *   * *     *     *     *   *     *   * * *   * *   *   *             *   *
******* * ***** * *** *** * *** * *** ***** * * * * ******* *** * * ******* *** ***** * ******* * ***
*     * *     * *   * *   *       *   *     * * *   *             *       *   *       * *   *       *
*** *** ***** * * *** * *** * * ***** ***** ******* ********* ***** * ********* * * * * *** *** *** *
*   *   *     * * *   * *   * *   * *     *     * * *       *   *   *     *   * * * * *       * *   *
* * *** ***** *** * ******* * *** * * *** *** *** * *** ******************* *** ***** * * * * ***** *
* * *       * * *         * * *     *   * *         *   * *   * *     *   *     * *   * * *   * * * *
*** ***** * *** * *** *** * * * ******* ******* ******* * * *** *** *** ***** * * * *** * * *** * * *
*   *     * * *     * * * * * * *             *   *       *       * *         *   * *   * *     *   *
* ******* * * * ******* * ***** ********* ***** *** *** *** ***** * * * * *** * ******* * * ******* *
*     *   *   * *     *       *       * *         *   * *   *     * * * *   * * *       * *     *   *
* ***** ***** ******* ***** * *** *** * ********* *** ********* *** * * ***** *** *** * ***** *** * *
*           *               *       * *                               *   *         * *   *         *
************************************************** **************************************************