***************************************************+*************************************************
*   *                   *           * *       *   *+++++++  *               * *   *                 *
* ***** * *** *** * *** ***** *** * * * * * * *** * *****+*** ******* ***** * * * ***** *** * *** * *
* *     *   * * * *   *     *   * * *   * * *   *     *  +* *       *     *   * *         * * *   * *
* * ******* *** ***** * * * ***** ******* ***** *** * ***+* * ***** * ******* * * *** *** * *********
*   *         *   *   * * * *       *     * * * * * * *+++* *     * * *   *     *   * *   * * *   * *
* * *** ******* *** ******* *** ***** * *** * * * * ***+* * * *********** * * * ***** *** * * *** * *
* *   *   *     * *     *   *     *   *   *         *  +*       * *       * * *   *     * *   *     *
* ******* *** * * ******* *** *** * * ***** * *** *****+******* * *** * * * ******* *********** * ***
* *   *       *   *         *   * * *   * * *   * *    +++  *     * * * * * *               *   * * *
* *** * *** ***** * * * ***** *** * *** * * * * *** *****+********* *** *** * *** ******* * * * * * *
*   *   * * *   *   * *   *     *   * *     * *   * *+++++    *       *     * *       * * * * * * * *
* *** *** *** *** ******* ***** *** * ******* *******+* * * * * * ***** * ********* * * ***** * * * *
*   *   * * * *   * *   *   * * * *     *   * *+++*  +* * * * * * * * * *   *       *         * * * *
* ***** * * * * * * *** * *** *** ******* *****+*+***+*** *** * *** * * * ***** ********* ***** * * *
*   *   *   * * * *     * *     *   *+++++++++++*+++++*   *     *       * *   *   * *   * * *   *   *
* ***** *** * * ******* ***** *** ***+******* * *********** * *** * * * *** *** * * * * * * *********
* *   * *             *     *   *  +++*   * * * *           *     * * * *       * * * *   *   *     *
* *** * ***** * * ***** * *** * ***+*** *** ***** * *** * ******* *************** * ***** * * ***** *
* * *         * *       *     * *  +++*   *       * *   *   *   *       * * * * *           *     * *
* * *** *** ***** *** *** * ***** * *+* *** *** ***** * * *** *** ***** * * * * *** *** *** ***** * *
*   * * *       * * *   * * *     * *+++    *   *     * * * *         * *   *         * * *   *   * *
* *** ******* ***** ***** *** * *******+* *********** ***** * * ********* ***** * ***** * ******* * *
*           * * * *   *   * * * *     *+* * *     * * * *     *   *   *     * * *   *         *   * *
* ***** ***** * * *** *** * * *** *****+* * ***** * * * *********** * * *** * * * ******* ******* * *
* *   * *   *     *         * *  +++++++*   *     * *   *     *     *   * *   * * *         *   * * *
* * ***** *** ******* ***** *** *+* ***** *** * *** * * *** *** *** *** * *** * ******* * *** ***** *
* *   * *   * *       *   *   * *+* * * * *       *   *       *   * *       *   *       *   *       *
* * * * * *** ******* * *** *****+*** * * * * * * *** ******* ***** * * ******* ***** * * ******* ***
* * *               * *     * *+++*     * * * * * *   *   *   *     * *     * *   * * * * * *     * *
*** *** ********* * ***** *** *+******* * *** *** *** *** * ***** * * *** * * ***** * * *** *** * * *
*   * *     * *   * * *       *+    *       * *       *     *     * *   * * *   *     *   *     *   *
* *** ******* *** * * ***** * *+********* * ******* ***** *** ******* *** * *** ********* ***** * * *
*     *         * *       * * *+++*     * *     *   *         *         * *   *   *     *       * * *
* ******* * ***** *** *** *** ***+*** *** * ******* *** ***** *** * ***** ******* ***** * ******* * *
* * *     *   * *   *   * *   * *+++++* * *     *     * * *   * * *   * * *     *     * * * *       *
* * *** * *** * ***** *** * * * *****+* * *** ***** * *** ***** *** * * *** *** ***** * *** * *** ***
* *     * *   * * *     *           *+  *   *     * * *   * * *     * * *   * *   *   *     * * * * *
* * * ***** * * * * *** *** *** *** *+* * * ******* ***** * * * ***** * * *** *** *** ***** *** * * *
*   *   *   *   *     * *     * * * *+* * * *     *       *         *           * *     * * *       *
*** *** ***** *** * *********** * * *+***** ***** *********** * *** *** ***** ***** ***** * ******* *
* *   * *   * * * * *   *       *    +++*   * *         *   * *           *               * *       *
* * *** * ***** * ***** ********* *****+*** * *** ***** * *** * ***** ******* *** ********* ***** ***
*   *         *             *   * *    +  * *         * *     *     * *   * * *       * *           *
*** ***** *** ***** ******* *** *******+*** ********* * * *************** * * *** * *** * *** * *****
*       * * * *   *       * *       *+++*   *     * * *   *   * *       * *     * *     * *   *     *
* *** ***** *** ******* *** * *******+*** *** ***** *** * *** * * * * * * *** ***** *** *** ***** * *
* *           *       * *   *        +++*  +++* * * * * *     * * * * *     *     *   *       * * * *
* * * * * * ***** *** * *** ***** * * *+***+*+* * * * * *** *** * *** *********** * ******* *** *** *
* * * *   * * *   *     *     *   * * *+++++*+++++*     *       * * *         *   *   *       * *   *
* * *** ***** *********** ***********************+*** * * * *** *** *** ***** *********** *** * * * *
*     *   * *           *   *     *   *+++++++*+++*   * * * * * *     * *   *           *   *   * * *
* * * * * * *** *** ***** * * ******* *+* * *+*+*** *** *** * * * *** * * *** *** *** *** ***** *** *
* * * * *       *   *   * * * *     * *+* * *+++    *     * * *   *   * * *     * * *     *   *   * *
* *** ************* *** *** * ***** * *+*** *********** *** * * * *** *** * *** *** *** ***** * *** *
* *     *         *   *       *   * *+++*   *           *   *   * * *     * * *   *     *     *   * *
* *** ***** * ***** ******* ***** * *+*************** *** * ******* ******* * * * * ********* *** * *
* *     * * *       *   *     * *   *+++++*   *     *   * * *       *   * *   * *   * * *           *
* * * *** *********** ******* * * * * ***+*** *** ***** *** * *** ***** * ********* * * *** *** *** *
* * * *       * *   *             * * * *+*       *   * *       * *   *     *     *   *   *   * *   *
***** * * ***** * *** ***** ***** * * * *+* *** ***** *************** *** * * *** * ***** ********* *
*     * *       * * * *   * *     * *   *+*   *   *     * *   *   * * *   *     *         *     *   *
* ************* * * * * ***** ********* *+*** *** *** *** *** * *** * *** * * ******* ***** *** * ***
* *     *     * *   * *       *   * *   *+*     * * *   *           *   * * *   * *   *   *   * *   *
* ***** * ***** *** * * * *** * *** * ***+*** ***** * ***** ******* *** * *** *** * * * *** *** * * *
*   *   *     *     *   * *       * * *+++  *         *     * *         *   * *   * * * * * *   * * *
* *** ******* ***** ********* * * * ***+******* ***** *** *** * ********* *** * *** * * * * ******* *
* *     * *   *             * * *      +++*+++++++  *       *       * *   *       * * * *   *   * * *
* ***** * *** *** *** *** *** * *** * ***+*+*****+***** ******* * *** * ******* * ***** * *** *** * *
*   * *   * *       * * *   * * *   * *  +++*   *+*         * * * * * *   * *   *     * * *     *   *
* *** *** * * ******* * ******* *** *** ***** ***+* * * *** * ***** * * * * ******* * * * *** ***** *
*         *   *     * * * *       *   *     *   *+* * *   * *       *   *     * * * * * * *       * *
*** * * * * *** ***** * * *** ***** * ******* ***+*** *** ***** *** *** ******* * * *** * * * ***** *
*   * * *   *   *             * * * * *         *+* *   * *     * *         * *     *       * *   * *
***** ********* * * * ***** *** * * *** *** *** *+* * *** * * * * * ******* * * ***** * * *** * *** *
*       * *   *   * *     *   *         * * *    +*     * * * * * *   *               * *   *     * *
* * ***** *** * *********** *** *** ***** *** ***+******* * * *** * ************* *********** ***** *
* * *     *   *       *         *         * * * *+*   * * * * *   *   *     * *       *       *   * *
*** * ***** ***** * * ***** * ***** * ***** *** *+* * * *** *** ***** *** *** * * * * * *** ***** * *
* * *       *     * * *   * * *     * * * *     *+* *   *   *     * * * *       * * * * *   * *     *
* * *** ***************** ********* *** * * *** *+* *** * ***** *** * * *** * *************** ***** *
*   *   *       *           *   * *   * * *   *+++* * * *   *           * * *   *       *     *     *
*** * *** *** * ******* *** * *** * * * * *****+* *** * *** * ******* *** *********** ***** *** *** *
* * * * * * * * * * *   * *     *   * *   *+++++* *     * * *   *         * *         *   * *   *   *
* * * * *** * *** * * * * *** *** ***** ***+* *** *** *** *** * * ******* * * *** *** * * * ******* *
* *     *   *         * *   *         * * *+* *     *     *   * *   * *     *       * * *     *   * *
* *** *** * ******* ***** ************* * *+* * * * ***** ***** * *** *** * * *************** * *** *
* *   * * *       * * *   *   * *     * *  +* * *   * *       * *   * * * *             *   *   * * *
* *** * *** ******* * * ***** * ***** * ***+********* ***** *** ***** * * *** *** * * *** * *** * * *
* *     *           *   *         * * *  +++*                 *         *   *   * * * *   *       * *
* ***** ********* ***** * * ******* * ***+*** ***** * ******* * ******* * ******* *** ******* ***** *
* *             *   * *   *     * *      +++  *   * *   *     *     *   *     * * * *   *     *   * *
* * * *** *********** * * * * *** *********+* * * * ***** *** * * *** * ***** * * * ***** ***** *** *
*   *   * *     * * *   * * *   *   *   *+++* * *     * * * * * *     * *   * *   * *           * * *
***** *** * * * * * * *** * ******* * * *+************* *** * * ***** ***** ***** * ******* ***** * *
*   * *   * * *     *   * *           * *+*     * *   *   * *   * * *   * * * *   * *         *     *
* * * ***** ***** *** * *** ***** * *****+* ***** * *** *** * * * * * *** * * *** * * * * * ***** ***
* *       * *     * * * *   *     *   *  +*   *     *         *     *   *   *     *   * * * *       *
* *** ***** ******* * * *** *************+*** *** * *************** ***** *** *** *** *** * ******* *
*   *                 *   *              +++++++++*             *               *     *   *         *
*************************************************+***************************************************
