***************************************************+*************************************************
*   *                   *           * *       *   *+++++++  *               * *   *                 *
* ***** * *** *** * *** ***** *** * * * * * * *** * *****+*** ******* ***** * * * ***** *** * *** * *
* *     *   * * * *   *     *   * * *   * * *   *     *  +* *       *     *   * *         * * *   * *
* * ******* *** ***** * * * ***** ******* ***** *** * ***+* * ***** * ******* * * *** *** * *********
*   *         *   *   * * * *       *     * * * * * * *+++* *     * * *   *     *   * *   * * *   * *
* * *** ******* *** ******* *** ***** * *** * * * * ***+* * * *********** * * * ***** *** * * *** * *
* *   *   *     * *     *   *     *   *   *         *  +*       * *       * * *   *     * *   *     *
* ******* *** * * ******* *** *** * * ***** * *** *****+******* * *** * * * ******* *********** * ***
* *   *       *   *         *   * * *   * * *   * *    +++  *     * * * * * *               *   * * *
* *** * *** ***** * * * ***** *** * *** * * * * *** *****+********* *** *** * *** ******* * * * * * *
*   *   * * *   *   * *   *     *   * *     * *   * *    +++++*       *     * *       * * * * * * * *
* *** *** *** *** ******* ***** *** * ******* ******* * * * *+* * ***** * ********* * * ***** * * * *
*   *   * * * *   * *   *   * * * *     *   * *   *   * * * *+* * * * * *   *       *         * * * *
* ***** * * * * * * *** * *** *** ******* ***** * *** *** ***+* *** * * * ***** ********* ***** * * *
*   *   *   * * * *     * *     *   *           *     *   *+++  *       * *   *   * *   * * *   *   *
* ***** *** * * ******* ***** *** *** ******* * ***********+* *** * * * *** *** * * * * * * *********
* *   * *             *     *   *     *   * * * *+++++++++++*     * * * *       * * * *   *   *     *
* *** * ***** * * ***** * *** * *** *** *** *****+* *** * ******* *************** * ***** * * ***** *
* * *         * *       *     * *     *   *+++++++* *   *   *   *       * * * * *           *     * *
* * *** *** ***** *** *** * ***** * * * ***+*** ***** * * *** *** ***** * * * * *** *** *** ***** * *
*   * * *       * * *   * * *     * *    +++*   *     * * * *         * *   *         * * *   *   * *
* *** ******* ***** ***** *** * ******* *+*********** ***** * * ********* ***** * ***** * ******* * *
*           * * * *   *   * * * *     * *+* *     * * * *     *   *   *     * * *   *         *   * *
* ***** ***** * * *** *** * * *** ***** *+* ***** * * * *********** * * *** * * * ******* ******* * *
* *   * *   *     *         * *         *+  *     * *   *     *     *   * *   * * *         *   * * *
* * ***** *** ******* ***** *** * * *****+*** * *** * * *** *** *** *** * *** * ******* * *** ***** *
* *   * *   * *       *   *   * * * * * *+*       *   *       *   * *       *   *       *   *       *
* * * * * *** ******* * *** ***** *** * *+* * * * *** ******* ***** * * ******* ***** * * ******* ***
* * *               * *     * *   *     *+* * * * *   *   *   *     * *     * *   * * * * * *     * *
*** *** ********* * ***** *** * ******* *+*** *** *** *** * ***** * * *** * * ***** * * *** *** * * *
*   * *     * *   * * *       *     *    +  * *       *     *     * *   * * *   *     *   *     *   *
* *** ******* *** * * ***** * * *********+* ******* ***** *** ******* *** * *** ********* ***** * * *
*     *         * *       * * *   *     *+*     *   *         *         * *   *   *     *       * * *
* ******* * ***** *** *** *** *** *** ***+* ******* *** ***** *** * ***** ******* ***** * ******* * *
* * *     *   * *   *   * *   * *     * *+*     *     * * *   * * *   * * *     *     * * * *       *
* * *** * *** * ***** *** * * * ***** * *+*** ***** * *** ***** *** * * *** *** ***** * *** * *** ***
* *     * *   * * *     *           *   *+++*     * * *   * * *     * * *   * *   *   *     * * * * *
* * * ***** * * * * *** *** *** *** * * * *+******* ***** * * * ***** * * *** *** *** ***** *** * * *
*   *   *   *   *     * *     * * * * * * *+*     *       *         *           * *     * * *       *
*** *** ***** *** * *********** * * * *****+***** *********** * *** *** ***** ***** ***** * ******* *
* *   * *   * * * * *   *       *       *  +* *         *   * *           *               * *       *
* * *** * ***** * ***** ********* ***** ***+* *** ***** * *** * ***** ******* *** ********* ***** ***
*   *         *             *   * *       *+*         * *     *     * *   * * *       * *           *
*** ***** *** ***** ******* *** ******* ***+********* * * *************** * * *** * *** * *** * *****
*       * * * *   *       * *       *   *+++*     * * *   *   * *       * *     * *     * *   *     *
* *** ***** *** ******* *** * ******* ***+*** ***** *** * *** * * * * * * *** ***** *** *** ***** * *
* *           *       * *   *           *+++++* * * * * *     * * * * *     *     *   *       * * * *
* * * * * * ***** *** * *** ***** * * * *** *+* * * * * *** *** * *** *********** * ******* *** *** *
* * * *   * * *   *     *     *   * * *     *+++++*     *       * * *         *   *   *       * *   *
* * *** ***** *********** ***********************+*** * * * *** *** *** ***** *********** *** * * * *
*     *   * *           *   *     *   *+++++++*+++*   * * * * * *     * *   *           *   *   * * *
* * * * * * *** *** ***** * * ******* *+* * *+*+*** *** *** * * * *** * * *** *** *** *** ***** *** *
* * * * *       *   *   * * * *     * *+* * *+++    *     * * *   *   * * *     * * *     *   *   * *
* *** ************* *** *** * ***** * *+*** *********** *** * * * *** *** * *** *** *** ***** * *** *
* *     *         *   *       *   * *+++*   *           *   *   * * *     * * *   *     *     *   * *
* *** ***** * ***** ******* ***** * *+*************** *** * ******* ******* * * * * ********* *** * *
* *     * * *       *   *     * *   *+++++*   *     *   * * *       *   * *   * *   * * *           *
* * * *** *********** ******* * * * * ***+*** *** ***** *** * *** ***** * ********* * * *** *** *** *
* * * *       * *   *             * * * *+*       *   * *       * *   *     *     *   *   *   * *   *
***** * * ***** * *** ***** ***** * * * *+* *** ***** *************** *** * * *** * ***** ********* *
*     * *       * * * *   * *     * *   *+*   *   *     * *   *   * * *   *     *         *     *   *
* ************* * * * * ***** ********* *+*** *** *** *** *** * *** * *** * * ******* ***** *** * ***
* *     *     * *   * *       *   * *   *+*     * * *   *           *   * * *   * *   *   *   * *   *
* ***** * ***** *** * * * *** * *** * ***+*** ***** * ***** ******* *** * *** *** * * * *** *** * * *
*   *   *     *     *   * *       * * *+++  *         *     * *         *   * *   * * * * * *   * * *
* *** ******* ***** ********* * * * ***+******* ***** *** *** * ********* *** * *** * * * * ******* *
* *     * *   *             * * *      +++*+++++++  *       *       * *   *       * * * *   *   * * *
* ***** * *** *** *** *** *** * *** * ***+*+*****+***** ******* * *** * ******* * ***** * *** *** * *
*   * *   * *       * * *   * * *   * *  +++*   *+*         * * * * * *   * *   *     * * *     *   *
* *** *** * * ******* * ******* *** *** ***** ***+* * * *** * ***** * * * * ******* * * * *** ***** *
*         *   *     * * * *       *   *     *   *+* * *   * *       *   *     * * * * * * *       * *
*** * * * * *** ***** * * *** ***** * ******* ***+*** *** ***** *** *** ******* * * *** * * * ***** *
*   * * *   *   *             * * * * *         *+* *   * *     * *         * *     *       * *   * *
***** ********* * * * ***** *** * * *** *** *** *+* * *** * * * * * ******* * * ***** * * *** * *** *
*       * *   *   * *     *   *         * * *    +*     * * * * * *   *               * *   *     * *
* * ***** *** * *********** *** *** ***** *** ***+******* * * *** * ************* *********** ***** *
* * *     *   *       *         *         * * * *+*   * * * * *   *   *     * *       *       *   * *
*** * ***** ***** * * ***** * ***** * ***** *** *+* * * *** *** ***** *** *** * * * * * *** ***** * *
* * *       *     * * *   * * *     * * * *     *+* *   *   *     * * * *       * * * * *   * *     *
* * *** ***************** ********* *** * * *** *+* *** * ***** *** * * *** * *************** ***** *
*   *   *       *           *   * *   * * *   *+++* * * *   *           * * *   *       *     *     *
*** * *** *** * ******* *** * *** * * * * *****+* *** * *** * ******* *** *********** ***** *** *** *
* * * * * * * * * * *   * *     *   * *   *+++++* *     * * *   *         * *         *   * *   *   *
* * * * *** * *** * * * * *** *** ***** ***+* *** *** *** *** * * ******* * * *** *** * * * ******* *
* *     *   *         * *   *         * * *+* *     *     *   * *   * *     *       * * *     *   * *
* *** *** * ******* ***** ************* * *+* * * * ***** ***** * *** *** * * *************** * *** *
* *   * * *       * * *   *   * *     * *  +* * *   * *       * *   * * * *             *   *   * * *
* *** * *** ******* * * ***** * ***** * ***+********* ***** *** ***** * * *** *** * * *** * *** * * *
* *     *           *   *         * * *  +++*                 *         *   *   * * * *   *       * *
* ***** ********* ***** * * ******* * ***+*** ***** * ******* * ******* * ******* *** ******* ***** *
* *             *   * *   *     * *      +++  *   * *   *     *     *   *     * * * *   *     *   * *
* * * *** *********** * * * * *** *********+* * * * ***** *** * * *** * ***** * * * ***** ***** *** *
*   *   * *     * * *   * * *   *   *   *+++* * *     * * * * * *     * *   * *   * *           * * *
***** *** * * * * * * *** * ******* * * *+************* *** * * ***** ***** ***** * ******* ***** * *
*   * *   * * *     *   * *           * *+*     * *   *   * *   * * *   * * * *   * *         *     *
* * * ***** ***** *** * *** ***** * *****+* ***** * *** *** * * * * * *** * * *** * * * * * ***** ***
* *       * *     * * * *   *     *   *  +*   *     *         *     *   *   *     *   * * * *       *
* *** ***** ******* * * *** *************+*** *** * *************** ***** *** *** *** *** * ******* *
*   *                 *   *              +++++++++*             *               *     *   *         *
*************************************************+***************************************************
