***************************************************+*************************************************
*             *     *         *   *               *+++*       *           *   *   *       *       * *
* ******* * *** * * * *** *** * * * ***** ***** * ***+*** *** ********* *** *** *** ***** * * ***** *
* *       *   * *     * * * *   * * *       * * *    +++  *       *   *   * * *       *     *   *   *
* * ********* * ******* * * *** ******* *** * * * * * *+*** ***** *** * *** * *** ***** ***** *** * *
* * *       *     * *   * *   *         *   *   * * * *+* * * *         *   *     *     *   *     * *
* ***** ***** * * * * * *** ***** ********* *** *** * *+* * * *** * * *** *** *** ***** * *** * * ***
* * * *     * * * * * *       *         *   *     * * *+++* *     *   *       *   *   *   *   * *   *
* * * * *** * *** * *** ******* *** *** * *** * *********+********* * *** *** * *** ***** * *** *****
* *   *   * * *         * *   * *   *   *   * *   * *    +    * *   *     *   * *     * * * * *     *
* *** *** * * * ******* * * ******* *** *** *** *** *** *+* *** * * ***** *** *** * *** ***** ***** *
*         *   *   * *       *     * *   * * *     *     *+*     * * *   *       * *   * *     *     *
* * ******* ***** * *** *** ***** * *** * * *** *********+*** *** *** * * *** *** * *** * * ******* *
* *     * * *     *   * *   * *     * * * * * *     *+++++  *     *   *   *   * * *     * * *     * *
* * ***** * * * ***** * *** * ***** * *** * * * * ***+***** * *** *** ***** * * ***** * * *** *** * *
* *   *   * * *   *       * * *   *   *     *   * * *+*     *   * * *   * * *   *     * * *       * *
* ***** * *** *** * ******* * * * ********* ***** * *+* * *** ***** ***** *** * * * * *** * ***** ***
*       * *   * * *   *         *     *   * * *     *+* * * *   *   *         *   * *       * *   * *
*** * * *** *** *** ******* * ********* ***** *** * *+*** * * *** ******* ***** * *** * *** * *** * *
* * * * *   * *   *   * *   *       *             *  +++*   *       *   *   *   * *   * * * *   * * *
* * ***** * * * * * * * * * * * * * ***** ******* *****+*** ***** *** ***** ***** * *** * * * *** * *
*   * *   *     * * *   * * * * * *   * *     * *      +* *     *     *     *     *   *   *   * *   *
* *** ******* * * * * *** ******* *** * ***** * * * ***+* ***** ***** * *** ******* ********* * * * *
* *         * * * * * *   * *   * *   * *   *   * * * *+++++*   *   * *   * * *         *       * * *
* ******* ******* * * *** * *** * ***** *** * ******* *****+***** * *** ***** * *** * ********* *** *
* *   * *     *   * * *     *     *     *+++++*   *       *+  * * *         *   * * *   *     * *   *
* * *** *** *** ******* *** * *** *** ***+***+*** ******* *+*** * ***** *** ***** *** ******* * *** *
*     *           *   * *   * *     *  +++*+++*   *     *+++*     *   *   * *   *   * *         * * *
***** *** ***** * * *** * *** *********+***+*** ***** ***+******* *** *** *** *** * ******* *** * * *
*     *     * * *   * * * * *     *    +*+++*    +++++++++*   * * *     *       * *     * * * * *   *
* *** * *** * * *** * * *** * *** *****+*+*******+* *** * *** * * ***** *********** *** * * * * *** *
* *   * * * *   *   *   *     *     * *+*+++*  +++* * * * * *               *     * * *     * *   * *
* *** *** ********* *** ***** ******* *+***+***+*** * * *** * *** ********* *** * * * * *** * * *** *
* * *       *   * *   *     *   *   *  +  *+++++  *   * * * *   *   * * * * *   *   *   * * * * * * *
* * *** *** *** * *** *** * *** * * * *+*********** * *** * ***** * * * * ***** *** *** * * * *** * *
*   *   * *       *     * * *   * *   *+++  *       * * *     *   * * *   *     * * *     * *     * *
* ******* ***** ********* * * ***** *** *+************* * *** * ***** *** * *** * * ***** * * * *** *
*         * *   *   *     *       * *   *+++++++    *     *     *           *   * * *   * * * *   * *
* *** *** * *** * *** *** *************** *** *+***** *** *** * * * *** ***** *** * *** * ******* * *
*   * * * * *       *   *   *     *     * *   *+        * *   * * * *   * *       * *   * * *     * *
*** *** *** *********** * ***** * * ***********+*** *** * ***** ******* * * *** * *** ***** *** *** *
*   * * *     *     *   * *     *   *   *      +  *   * * * * *     *   *     * *       *   * *     *
* * * * ***** * * * * * *********** * *********+******* * * * ***** * *** ******* ********* * * * * *
* *         * * * * * * *    +++*   * *+++++*+++* *   * *     *       *           *   * * * *   * * *
* *** ***** * * *** ******* *+*+*** * *+***+*+*** * ********* * *** *************** * * * * ******* *
* * * *   *       *   *   * *+*+++++++++  *+++*           *   *   *         *     * *             * *
* * ***** ********* ***** ***+******* ********* ***** ***** ***** * * * * * * *** ************* * ***
* *           *   *    +++++++  * * *       * * * * *     *   * * * * * * *     * *     *       *   *
* ***** *** *** * * * *+******* * * ***** * * *** * ***** *** * *** ******* ********* *** * *** * ***
* * * * * * *   * * * *+  *   *   * *     * *               *   *         *       * * *   *   * * * *
* * * *** * * * *******+*** ***** * * * *** ********* * * *** *** ***** * * *** * * * * ******* *** *
* *         * * *    +++  *     * *     *   *     *   * * *   * * * *   * *   * *         *     *   *
* * ***** * *** *** *+***** ************* *** *** *** * *** * * *** * *** ***** ********* * ******* *
*   *     * *       *+*+++++*+++*   *   *     *   *   * *   *       * * * *   * *       * *     *   *
* * *** * * * * * ***+*+* *+*+*+*** *** *** * * *** * ******* ***** *** ***** *** ***** * ********* *
* * *   * *   * *   *+++* *+*+*+  *   *     *   *   *       *   *   *     * * *   * *     *   * * * *
* ************* * * ***** *+*+*+***** *********** * ***** ***** * ***** * * * * * * * * * *** * * * *
* *         *   * *   *   *+++*+    * *           *   *   *     * *   * * *     *   * * *   * *     *
***** * *** * *** ********* ***+* *** *** *** * *** * ***** ******* ***** ***** *********** * * *** *
*     *   * *   *   * *   *   *+*     *     * *   * *   *     *       * *     * *     * *   *   *   *
* ******* * ******* * * * * ***+*** * ***** ***** * ***** * ******* *** *** *** *** * * * * *** *** *
* * *     *           * * *   *+* * *         * * *     * *     *         *   * *   *   * *       * *
* * * ***** * *** ******* *****+* ***** * ***** * *** * *** * ***** ***** *** * *** * * ******* *** *
*   *     * *   *     *    +++++*     * * * *   * * * *   * *     *   *         *   * *   * *   *   *
* *** *** * * * *** * *****+***** *** * *** * *** * * * *** ***** * * * ***** *** * * ***** *** *** *
*   * * * * * * *   *   * *+++* *   *     *         * *       * *   * * *     *   * * *       * *   *
*** *** ********* * ***** ***+* *** * * ***** *** ***** ***** * ***** ********* ***** * * * ******* *
*       *     * * *     *+++++    * * *     * * * *   *   *     *   * *       * *   * * * * *     * *
* ***** ***** * * * *****+* ******* * *** *** * ***** ********* *** * ***** * *** * * ***** * ***** *
* *   * * * *           *+*   *     * *   *     *   *         *             *   * *       *         *
* * *** * * *************+******* ***************** * ******* ********* *** *** *** *** ***** * *** *
* *   *         * *+++*+++  *         * * *     *   * * * *           *   * *     * *         * *   *
* * ***** ***** * *+*+*+* *** * ******* * * ******* *** * *** ***** *** ************* * * ***** *** *
*       * *     * *+*+*+*     * *   * *   *             * *   * *                 *   * *     * * * *
* * ********* *** *+*+*+********* * * * ******* * ***** * *** * *** ***** *** ******* *** * *** * * *
* *   *     *  +++++*+*+*   * *   *             * *   * *     *     *     * * * * *     * *   * *   *
* * ******* * *+*****+*+*** * *** *** *** ******* * * *** * *** * *** *** * *** * ******* ***** *** *
* *   * *   * *+  *  +++    *   * *     * * * *     *   * *   * * *   *     *     *         *   * * *
* ***** * * ***+******* *** *** * *** ***** * * *** ************* * *** *** *** * * *** ***** *** * *
*   *     * *+++*   *     * *   * * * *       * *         *     * *   *   *     *   * *   *   *   * *
* * *** *****+***** * ***** * * * * *** ***** * *** ******* ***** ***** ********* * * ***** *** *** *
* *       *  +*     * *   *   * * *         * * *   *         * * *       * *   * * *               *
* ******* * *+***** ***** *** ******* ***** *** * ***** * * * * * * ******* *** ******* ***** * *****
* *     *   *+*       * * * * *   * *   *     * *   * * * * *   * *   *   *   *   * * * * *   * * * *
*** * *** ***+*** * *** * * * * * * *** ***** * ***** *** ***** * * * *** * * *** * * *** * ***** * *
*   *     *  +++++* *   *     * *   *         * * *       * * * * * *     * *     *       *       * *
* *********** * *+* *** ********* * * ********* * * ***** * * * * * * *** * ***** * ******* ******* *
*           * * *+* *     *   * *+++++*     *     *   *     *   * * *   * *   *   *             *   *
******* * ***** *+*** *** * *** *+***+***** * * * * ******* *** * * ******* *** ***** * ******* * ***
*     * *     * *+  * *   *    +++*  +*     * * *   *             *       *   *       * *   *       *
*** *** ***** * *+*** * *** * *+*****+***** ******* ********* ***** * ********* * * * * *** *** *** *
*   *   *     * *+*   * *   * *+++* *+    *     * * *       *   *   *     *   * * * * *       * *   *
* * *** ***** ***+* ******* * ***+* *+*** *** *** * *** ******************* *** ***** * * * * ***** *
* * *       * * *+++++++++* * *+++  *+++* *         *   * *   * *     *   *     * *   * * *   * * * *
*** ***** * *** * *** ***+* * *+*******+******* ******* * * *** *** *** ***** * * * *** * * *** * * *
*   *     * * *     * * *+* * *+*      +++    *   *       *       * *         *   * *   * *     *   *
* ******* * * * ******* *+*****+*********+***** *** *** *** ***** * * * * *** * ******* * * ******* *
*     *   *   * *     *  +++++*+++    * *+++++++++*   * *   *     * * * *   * * *       * *     *   *
* ***** ***** ******* ***** *+***+*** * *********+*** ********* *** * * ***** *** *** * ***** *** * *
*           *               *+++++  * *          ++                   *   *         * *   *         *
**************************************************+**************************************************