*************************************************** *************************************************
*   *                   *           * *       *   *         *               * *   *                 *
* ***** * *** *** * *** ***** *** * * * * * * *** * ***** *** ******* ***** * * * ***** *** * *** * *
* *     *   * * * *   *     *   * * *   * * *   *     *   * *       *     *   * *         * * *   * *
* * ******* *** ***** * * * ***** ******* ***** *** * *** * * ***** * ******* * * *** *** * *********
*   *         *   *   * * * *       *     * * * * * * *   * *     * * *   *     *   * *   * * *   * *
* * *** ******* *** ******* *** ***** * *** * * * * *** * * * *********** * * * ***** *** * * *** * *
* *   *   *     * *     *   *     *   *   *         *   *       * *       * * *   *     * *   *     *
* ******* *** * * ******* *** *** * * ***** * *** ***** ******* * *** * * * ******* *********** * ***
* *   *       *   *         *   * * *   * * *   * *         *     * * * * * *               *   * * *
* *** * *** ***** * * * ***** *** * *** * * * * *** ***** ********* *** *** * *** ******* * * * * * *
*   *   * * *   *   * *   *     *   * *     * *   * *         *       *     * *       * * * * * * * *
* *** *** *** *** ******* ***** *** * ******* ******* * * * * * * ***** * ********* * * ***** * * * *
*   *   * * * *   * *   *   * * * *     *   * *   *   * * * * * * * * * *   *       *         * * * *
* ***** * * * * * * *** * *** *** ******* ***** * *** *** *** * *** * * * ***** ********* ***** * * *
*   *   *   * * * *     * *     *   *           *     *   *     *       * *   *   * *   * * *   *   *
* ***** *** * * ******* ***** *** *** ******* * *********** * *** * * * *** *** * * * * * * *********
* *   * *             *     *   *     *   * * * *           *     * * * *       * * * *   *   *     *
* *** * ***** * * ***** * *** * *** *** *** ***** * *** * ******* *************** * ***** * * ***** *
* * *         * *       *     * *     *   *       * *   *   *   *       * * * * *           *     * *
* * *** *** ***** *** *** * ***** * * * *** *** ***** * * *** *** ***** * * * * *** *** *** ***** * *
*   * * *       * * *   * * *     * *       *   *     * * * *         * *   *         * * *   *   * *
* *** ******* ***** ***** *** * ******* * *********** ***** * * ********* ***** * ***** * ******* * *
*           * * * *   *   * * * *     * * * *     * * * *     *   *   *     * * *   *         *   * *
* ***** ***** * * *** *** * * *** ***** * * ***** * * * *********** * * *** * * * ******* ******* * *
* *   * *   *     *         * *         *   *     * *   *     *     *   * *   * * *         *   * * *
* * ***** *** ******* ***** *** * * ***** *** * *** * * *** *** *** *** * *** * ******* * *** ***** *
* *   * *   * *       *   *   * * * * * * *       *   *       *   * *       *   *       *   *       *
* * * * * *** ******* * *** ***** *** * * * * * * *** ******* ***** * * ******* ***** * * ******* ***
* * *               * *     * *   *     * * * * * *   *   *   *     * *     * *   * * * * * *     * *
*** *** ********* * ***** *** * ******* * *** *** *** *** * ***** * * *** * * ***** * * *** *** * * *
*   * *     * *   * * *       *     *       * *       *     *     * *   * * *   *     *   *     *   *
* *** ******* *** * * ***** * * ********* * ******* ***** *** ******* *** * *** ********* ***** * * *
*     *         * *       * * *   *     * *     *   *         *         * *   *   *     *       * * *
* ******* * ***** *** *** *** *** *** *** * ******* *** ***** *** * ***** ******* ***** * ******* * *
* * *     *   * *   *   * *   * *     * * *     *     * * *   * * *   * * *     *     * * * *       *
* * *** * *** * ***** *** * * * ***** * * *** ***** * *** ***** *** * * *** *** ***** * *** * *** ***
* *     * *   * * *     *           *   *   *     * * *   * * *     * * *   * *   *   *     * * * * *
* * * ***** * * * * *** *** *** *** * * * * ******* ***** * * * ***** * * *** *** *** ***** *** * * *
*   *   *   *   *     * *     * * * * * * * *     *       *         *           * *     * * *       *
*** *** ***** *** * *********** * * * ***** ***** *********** * *** *** ***** ***** ***** * ******* *
* *   * *   * * * * *   *       *       *   * *         *   * *           *               * *       *
* * *** * ***** * ***** ********* ***** *** * *** ***** * *** * ***** ******* *** ********* ***** ***
*   *         *             *   * *       * *         * *     *     * *   * * *       * *           *
*** ***** *** ***** ******* *** ******* *** ********* * * *************** * * *** * *** * *** * *****
*       * * * *   *       * *       *   *   *     * * *   *   * *       * *     * *     * *   *     *
* *** ***** *** ******* *** * ******* *** *** ***** *** * *** * * * * * * *** ***** *** *** ***** * *
* *           *       * *   *           *     * * * * * *     * * * * *     *     *   *       * * * *
* * * * * * ***** *** * *** ***** * * * *** * * * * * * *** *** * *** *********** * ******* *** *** *
* * * *   * * *   *     *     *   * * *     *     *     *       * * *         *   *   *       * *   *
* * *** ***** *********** *********************** *** * * * *** *** *** ***** *********** *** * * * *
*     *   * *           *   *     *   *       *   *   * * * * * *     * *   *           *   *   * * *
* * * * * * *** *** ***** * * ******* * * * * * *** *** *** * * * *** * * *** *** *** *** ***** *** *
* * * * *       *   *   * * * *     * * * * *       *     * * *   *   * * *     * * *     *   *   * *
* *** ************* *** *** * ***** * * *** *********** *** * * * *** *** * *** *** *** ***** * *** *
* *     *         *   *       *   * *   *   *           *   *   * * *     * * *   *     *     *   * *
* *** ***** * ***** ******* ***** * * *************** *** * ******* ******* * * * * ********* *** * *
* *     * * *       *   *     * *   *     *   *     *   * * *       *   * *   * *   * * *           *
* * * *** *********** ******* * * * * *** *** *** ***** *** * *** ***** * ********* * * *** *** *** *
* * * *       * *   *             * * * * *       *   * *       * *   *     *     *   *   *   * *   *
***** * * ***** * *** ***** ***** * * * * * *** ***** *************** *** * * *** * ***** ********* *
*     * *       * * * *   * *     * *   * *   *   *     * *   *   * * *   *     *         *     *   *
* ************* * * * * ***** ********* * *** *** *** *** *** * *** * *** * * ******* ***** *** * ***
* *     *     * *   * *       *   * *   * *     * * *   *           *   * * *   * *   *   *   * *   *
* ***** * ***** *** * * * *** * *** * *** *** ***** * ***** ******* *** * *** *** * * * *** *** * * *
*   *   *     *     *   * *       * * *     *         *     * *         *   * *   * * * * * *   * * *
* *** ******* ***** ********* * * * *** ******* ***** *** *** * ********* *** * *** * * * * ******* *
* *     * *   *             * * *         *         *       *       * *   *       * * * *   *   * * *
* ***** * *** *** *** *** *** * *** * *** * ***** ***** ******* * *** * ******* * ***** * *** *** * *
*   * *   * *       * * *   * * *   * *     *   * *         * * * * * *   * *   *     * * *     *   *
* *** *** * * ******* * ******* *** *** ***** *** * * * *** * ***** * * * * ******* * * * *** ***** *
*         *   *     * * * *       *   *     *   * * * *   * *       *   *     * * * * * * *       * *
*** * * * * *** ***** * * *** ***** * ******* *** *** *** ***** *** *** ******* * * *** * * * ***** *
*   * * *   *   *             * * * * *         * * *   * *     * *         * *     *       * *   * *
***** ********* * * * ***** *** * * *** *** *** * * * *** * * * * * ******* * * ***** * * *** * *** *
*       * *   *   * *     *   *         * * *     *     * * * * * *   *               * *   *     * *
* * ***** *** * *********** *** *** ***** *** *** ******* * * *** * ************* *********** ***** *
* * *     *   *       *         *         * * * * *   * * * * *   *   *     * *       *       *   * *
*** * ***** ***** * * ***** * ***** * ***** *** * * * * *** *** ***** *** *** * * * * * *** ***** * *
* * *       *     * * *   * * *     * * * *     * * *   *   *     * * * *       * * * * *   * *     *
* * *** ***************** ********* *** * * *** * * *** * ***** *** * * *** * *************** ***** *
*   *   *       *           *   * *   * * *   *   * * * *   *           * * *   *       *     *     *
*** * *** *** * ******* *** * *** * * * * ***** * *** * *** * ******* *** *********** ***** *** *** *
* * * * * * * * * * *   * *     *   * *   *     * *     * * *   *         * *         *   * *   *   *
* * * * *** * *** * * * * *** *** ***** *** * *** *** *** *** * * ******* * * *** *** * * * ******* *
* *     *   *         * *   *         * * * * *     *     *   * *   * *     *       * * *     *   * *
* *** *** * ******* ***** ************* * * * * * * ***** ***** * *** *** * * *************** * *** *
* *   * * *       * * *   *   * *     * *   * * *   * *       * *   * * * *             *   *   * * *
* *** * *** ******* * * ***** * ***** * *** ********* ***** *** ***** * * *** *** * * *** * *** * * *
* *     *           *   *         * * *     *                 *         *   *   * * * *   *       * *
* ***** ********* ***** * * ******* * *** *** ***** * ******* * ******* * ******* *** ******* ***** *
* *             *   * *   *     * *           *   * *   *     *     *   *     * * * *   *     *   * *
* * * *** *********** * * * * *** ********* * * * * ***** *** * * *** * ***** * * * ***** ***** *** *
*   *   * *     * * *   * * *   *   *   *   * * *     * * * * * *     * *   * *   * *           * * *
***** *** * * * * * * *** * ******* * * * ************* *** * * ***** ***** ***** * ******* ***** * *
*   * *   * * *     *   * *           * * *     * *   *   * *   * * *   * * * *   * *         *     *
* * * ***** ***** *** * *** ***** * ***** * ***** * *** *** * * * * * *** * * *** * * * * * ***** ***
* *       * *     * * * *   *     *   *   *   *     *         *     *   *   *     *   * * * *       *
* *** ***** ******* * * *** ************* *** *** * *************** ***** *** *** *** *** * ******* *
*   *                 *   *                       *             *               *     *   *         *
************************************************* ***************************************************